SNVID,Gene,Ref,Alt,Position,Range,Start,End,Length,Distance5End,Distance3End,ForwardSeq,ReverseSeq,ForwardLen,ReverseLen
SNV1,mt-Nd3,T,C,9461,9350-9534,9350,9534,185,111,73,CTGACTTTTCCTATACGTCTCCA,GGGGGAGTCAGAATGCAACTA,23,21
SNV2,mt-Nd5,C,A,12913,12783-12973,12783,12973,191,130,60,CATAGCCTGGCAGACGAACA,ATTAGTAGGGCTCAGGCGTTG,20,21
SNV3,mt-Co3,G,A,9027,8888-9093,8888,9093,206,139,66,TGCAGGATTCTTCTGAGCGT,GGGCTTGATTTATGTGGTTTCGT,20,23
SNV4,mt-Co1,G,A,6543,6409-6580,6409,6580,172,134,37,CATCCCTTGACATCGTGCTTC,AATATGATGGCGAAGTGGGCT,21,21
SNV5,mt-Tq,T,C,3816,3750-3892,3750,3892,143,66,76,AGAGGTTCAAGCCCTCTTATTT,CAACGTTTTCGGGGTATGGG,22,20
SNV6,mt-Nd6,C,T,13776,13701-13889,13701,13889,189,75,113,ACCAATCTCCCAAACCATCAAG,GGGGGATGTTGGTTGTGTTT,22,20
SNV7,mt-Nd1,G,T,3079,2970-3156,2970,3156,187,109,77,GCACCTACCCTATCACTCACAC,CGGCTCGTAAAGCTCCGAA,22,19
SNV8,D-Loop,A,G,16029,16008-16184,16008,16184,177,21,155,GTCCGCAAAACCCAATCACC,TGATCAGGACATAGGGTTTGATAGT,20,25
SNV9,mt-Co2,T,C,7612,7540-7725,7540,7725,186,72,113,AGGCCGACTAAATCAAGCAA,AGGTTAACGCTCTTAGCTTC,20,20
SNV10,mt-Rnr2,T,C,2651,2591-2792,2591,2792,202,60,141,ACCTTACAAATAAGCGCTCTCAAC,TAGAATGGGGACGAGGAGTGT,24,21
SNV11,mt-Cytb,C,T,15191,15155-15330,15155,15330,176,36,139,AATTGGGGGCCAACCAGTAG,TTCAGGTTTACAAGACCAGAGT,20,22
SNV12,mt-Rnr2,T,A,1317,1201-1350,1201,1350,150,116,33,ATAGAACTAGTACCGCAAGGGA,GTAGCTCGTTTGGTTTCGGG,22,20
